#Level1
## Time ###############################################
100

## Cars ###############################################
#MIN | MAX | PATTERN
############ 00 01 02  03 04 05  06 07 08  09 10 11 
 -50   -50    0  0  0   0  0  0   0  0  0   0  0  0 
 -50   -50    0  0  0   0  0  0   0  0  0   0  0  0 
 +50   +50    0  0  0   0  0  0   0  0  0   0  0  0 
 -50   -50    0  0  0   0  0  0   0  0  0   0  0  0 
 +50   +50    1  0  1   1  0  1   1  0  1   1  0  1

## Tree ###############################################
#MIN | MAX | PATTERN
############ 00 01 02  03 04 05  06 07 08  09 10 11 
 -50   -50    1  1  1   1  1  1   1  1  1   1  1  1 
 -50   -50    0  0  0   0  0  0   0  0  0   0  0  0 
 -50   -50    1  1  1   1  1  1   1  1  1   1  1  1 
 -50   -50    0  0  0   0  0  0   0  0  0   0  0  0 
 -50   -50    1  1  1   1  1  1   1  1  1   1  1  1 


## Turtle ###############################################
#MIN | MAX | PATTERN
############ 00 01 02  03 04 05  06 07 08  09 10 11 
-50   -50    0  0  0   0  0  0   0  0  0   0  0  0 
-50   -50    2  0  2   0  2  0   2  0  2   0  2  0
-50   -50    0  0  0   0  0  0   0  0  0   0  0  0 
-50   -50    2  0  2   0  2  0   2  0  2   0  2  0
-50   -50    0  0  0   0  0  0   0  0  0   0  0  0 
