#Level1
## Time ###############################################
360

## Cars ###############################################
#MIN | MAX | PATTERN
############ 00 01 02  03 04 05  06 07 08  09 10 11 
 -00   -00    0  0  0   0  0  0   0  0  0   0  0  0 
 -00   -00    0  0  0   0  0  0   0  0  0   0  0  0 
 +00   +00    0  0  0   0  0  0   0  0  0   0  0  0 
 -00   -00    0  0  0   0  0  0   0  0  0   0  0  0 
 +00   +00    1  0  1   1  0  1   1  0  1   1  0  1

## Tree ###############################################
#MIN | MAX | PATTERN
############ 00 01 02  03 04 05  06 07 08  09 10 11 
 -00   -00    1  1  1   1  1  1   1  1  1   1  1  1 
 -00   -00    0  0  0   0  0  0   0  0  0   0  0  0 
 -00   -00    1  1  1   1  1  1   1  1  1   1  1  1 
 -00   -00    0  0  0   0  0  0   0  0  0   0  0  0 
 -00   -00    1  1  1   1  1  1   1  1  1   1  1  1 


## Turtle ###############################################
#MIN | MAX | PATTERN
############ 00 01 02  03 04 05  06 07 08  09 10 11 
-00   -00    0  0  0   0  0  0   0  0  0   0  0  0 
-00   -00    2  0  2   0  2  0   2  0  2   0  2  0
-00   -00    0  0  0   0  0  0   0  0  0   0  0  0 
-00   -00    2  0  2   0  2  0   2  0  2   0  2  0
-00   -00    0  0  0   0  0  0   0  0  0   0  0  0 
